admire	захоплюватися
ajar	привідкритий
apprehension	побоювання
aquiline	орлиний
artificial	штучний
astute	проникливий
become manifest 	стати явним
binding treaty	обов'язковий договір
blithe	життєрадісний
blunder	промах
bonehead	йолоп
boodle	хабар
brass-bound	в латунній оправі
brew	варити
bristle	щетинитися
bulky	громіздкої форми
by all means	неодмінно
cable	телеграма
chancellor	канцлер
chauffeur	шофер
chuckle	сміятися
claim	стверджувати
compartment	відсік
contraption	штуковина
conventions	умовності 
copper	мент
crook	шахрай
curtsey	реверанс
cut ice	робити стосунки теплішими
deceive 	обманути 
defiled	заплямований
deign	зволити
docile	слухняний
dough	тісто
eagle	орел
embassy 	посольство 
essentials go	щодо найнеобхіднішого
fiends 	демон
fix up	врегулювати
flatter	підлещуватися
form	хороший тон
gabled	гостроверхий
gasp	задихатися
gaunt	худорлявий
go out	потухла лампа
going subtly wrong	йде трохи не так
gol-darned	чортовий
got on to	добратися до
grasp of iron	залізна хватка
greedy	жадібний
gripped	схопили його
grudge	жаліти
gunner	стрілець
guttural	гортанний
halt	зупинка
Have your way!	Нехай буде по-твоєму
heavy-handed	нетактовний
hermit	відлюдник
humiliation	приниження
inconceivable	немислимо
indiscreet 	нескромний
indiscrete	невідірваний
inscription	надпис
insular	острівний
invect	звинувачувати
invective	лайка
It's beyond me.	Це вище моїх сил
lattice	решітка
leave to its fate	залишити напризволяще
legation	представництво 
linger	затримуватися
live it down 	пережити це
mad	божевільний 
malignant 	злий
marvel	дивуватися
master	опанувати
matched	зрівнятися
mind you	зауваж
mug	дурень
munitions	боєприпаси 
named after	названий на честь
naval	військово-морський
neatly	акуратно
nitsky	ні з чим
Nothing doing!	Діло не піде
observed	необхідно дотримуватися 
palate	смак
parcel	посилка
passion	гнів
pensive	задумливий
personify	уособлювати
pilgrimage	паломництво
pose	удавання
precautions	запобіжні заходи
prejudice 	забобон 
ramp	бушувати
rascal	шахрай
reckon you	Я вважаю тебе
refrain	утримуватися
resemblance	схожість
resign	звільнитися
retire	піти
revelry	гулянка
ripen	дозрівати
salver	піднос
sealed	закупорений
Search me!	Не маю уявлення!
sedately	статечно
segregation	поділ
self-absorption	егоцентризм
setback	невдача
shiver	тремтіти
shouldering 	тліючий
slumbers	дрімота
sodden	промоклий
somnolence	сонливість
soothe	заспокоювати
spare	запасний
sparking plugs	свічки запалювання
splendid	чудовий
stand the racket	розплачуватися
stertorously	суворо
stir up	розворушити
stool pigeon	доносчик (інформатор)
strap	пристебнути
strike	вдарити
stroke	гладити
stroll out	прогулятися
study	двері кабінету
subordinate	підлеглий
superficial	зовнішній
superscription	надпис
taken it over	він взявся за це
thickset	коренастий
thoroughly	ретельно
tranquill	спокійний
turn a shade paler	бліднішати
vague	нечіткий
vigil	пильнування
wad	кусок
wandering 	мандруючий
wince	здригатися
woozy	очманілий
you don't tell me	невже
captor	викрадач
deliberate	обачний
warble	наспівувати
ditty	частівка
lamented	оплакуваний недавно
traitor	зрадник
immaterial	несуттєво
sat up	підвівся
envoy	посланець
groan	стогнати
clutch	вхопитися
outwit	обхитрити
prostrate	розпростертий
ignoble	неблагородний
foe	ворог
tread	ступати
hoist	піднімати
wedge	вклинюватися
amenities	зручності
outrageous	обурливий
accomplice	спільник
dangle	бовтатися
whence	звідки
chat	балакати
vainly	марно
wriggle	звиватися
wither	в’янути
of old	давним давно
page	паж (хлопчик-слуга до 12 років)
sufficiently	доволі
keen on	захоплюватися
baggy	мішкуватий
lean against	притулитися до
obliging	послужливий
confound	ставити в тупик
facsimile	точна копія
dressing-gown	халат
from over yonder	звідти
faculties	здібності
blessing	прощальне благословення
twitch	смикатися
exageration	перебільшення
Count me in!	Розраховуй на мене!
occasion	він був на висоті
fib	прибрехати
vice	порок
cast a net	закинути сіті
shackles	кандали
lay one by the heels	ув'язнити
credulous	легковірний
gudgeon	бевзь
flop	плюхнутися
elbow	майже під носом
by your leave	з вашого дозволу
incarnate	втілювати
whimsical happenings	химерні події
fancy	уява
tray	піднос
grasp the nettle	кувати залізо поки гаряче
hang about	нависати
warily	насторожено
fatuous	безглуздий
show him in	привести його
earnest	серйозно
sticks at nothing	він ні за що не тримається
You would be horribly in the way.	Ви б жахливо заважали.
usher	вступати
swarthy	смуглявий
moustache	вуса
surmounted	увінчаний
flamboyant	яскравий
impassive	незворушний
gave a violent start.	Він різко стрепенувся.
stagger	хитатися
cane	тростина
mock	висміювати
opportune	доречний
scowl	хмуритися
threatening	грізний
rogues' gallery	галерея розбійників
alleged	нібито
contemptuously	зневажливо
impersonation	уособлення
deplore	жалкувати
neglect	нехтувати
knotted	замислуватий
menace	загроза
dogged	ухилився
pest	шкідник
nutshell	в двох словах
hip pocket	задня кишеня
squat	приземкуватий
vile	підлий
forged check	підроблений чек
trumps	козирі
humdrum	банальний
bully	хуліган
peach	доносити
compound a felony	скоїти тяжкий злочин
give it up	відмовитися від цього
slip	зробити промах
commission	доручення
protruding	виступаючий
anticipation	очікування
tense	напружений
give ourselves up	віддати себе
estimable	шановний
dull	нудно
obstinate	впертий
puzzled	спантеличений
debonair	ввічливий
astute	проникливий
racous	хрипкий
withdrew	відходити
long-drawn	протяжний
wailing	тужливий
haunting	нав'язливий
faintly	слабко
sallow	блідий
Half a mo (Half a moment)	Зачекай
effigy	опудало
Strike me!	Побий мене грім!
lag	висилати на каторгу
swag	здобич
quid	фунтів стерлінгів
pate	голова (маківка)
faint	невиразний
bogus confession	фальшиве зізнання
Confound it! (Damn it!)	Чорт забирай!
whining	скигливий
lodging	житло
unflattering	невтішний
cast	кидати
associate	співучасник
snatch	викрадати
leap	стрибати
villain	злодій
stagger	хитатися
utter	повний
bewilderment	здивування
fancy	фантазувати
racy	колоритний
rate	у будь-якому випадку
appreciate	цінувати
blooming	квітучий
inrush	раптове вторгнення
linger	затриматися
laurels	лаври
eminent	видатний
imperturbable	незворушний
peer	лорд
 venture	ризикнути
austere	суворий
conjecture	здогадуватися
hatchet	сокира
feeble gait	слабка хода
affably	люб'язно
insidious	підступний
sneer	насмішка
perplexed	спантеличений
regard	вважати
all-sufficient	самодостатній
premature	передчасний
intolerable	нестерпний
stammer	заїкатися
impish	вредний
bewildered	збентежений
perwerted	збочений
exalted	величний
atonement	відкуплення
shag	трахатися
creep	повзати
dispel	розвіювати
agitated	схвильований
entombed	похований
tin	олово
obtain	отримати
ventilate	обговорювати
reticence	стриманість
discretion	стриманість
peculiar	своєрідний
shag	махорка (табак низ. сорту)
whetstone	точильний камінь
interject	вставляти
huddle	тулитися
furrowed brow	насуплені брови
throe	мука(агонія)
vexatious	прикрий
reverie	замріяність
whimsical	химерний
submit	подати на розгляд
speculation	припущення
couple	зв'язати
smug	самовдоволений
frisky	жвавий
gloomy	похмурий
snarl	гарчати
passing	передача
far-fetched	надумано
tangled skein	заплутаний клубок
wolfhound	вовкодав
endeavour	намагатися
grave	важливий
staid	урівноважений
apparently	мабуть
molest	надокучати
self-possession	самовладання
has every claim upon	має всі підстави для
go over the ground	викласти основні факти
due	належним чином
current	потік
courting	залицяння
frenzy	шаленство
infatuation	закоханість
objection	заперечення
eligible	прийнятний
fortnight	два тижні
allusion	натяк
frank	відвертий
chanced	випадково
furtive	потайний (скритний)
handle	обробляти
quaint	чудернацький
cannula	канюля (тупа мед.голка)
reprove	докоряти
rank	займати певне місце
admirable	чудовий
ban	забороняти
banish	вигнати
affectionate	ласкавий
reproach	докір
rigid	суворий
grim remembrance	похмурий спогад
night before last	позаминулої ночі
dull	тупий
muffled	приглушений
peep out	визирнути
crouch	повзти
spat out	виплюнути
atrocious	жахливий
utterly	зовсім
wit's end	поняття не мати
suggestive	що наводить на роздуми
alienist	психіатр
cerebral	мозковий
bargain	торговельна угода
fiancee	наречена
obscure	невиразний
recollection	спогад
shell	оболонка
jackass	дурень
impend	насуватися
blind	штора
frenzy	божевілля
window pane	шибка
delusion	омана
deceive	обманювати
allusion	натяк
thoroughly	цілком
allude	натякати
bearing	значення
irascible	запальний
cogent	переконливий
lot	доля
albeit	хоча
frantic	шалений
inconsiderable	незначний
hazy	туманний
venture	наважуватися
effrontery	нахабство
commend	хвалити
compound	сполучати
handsom	красивий
hansom	двоколісний екіпаж
college	коледж
colleague	колега
pull up	спиняти
gird	оточувати
grizzle	сивина
shaggy	кудлатий
vagary	примхливість
portly	повний
verge	межа
cunning	хитрість
amiably	люб'язно
assertion	твердження
bear out	підтверджувати
summon	закликати
asperity	грубість
unintelligibly	нерозбірливо
gibber	торохтіти
courtesy	ввічливість
sulkily	насуплено
sulk	дутися
amuse	розважати
crude	грубий
pant	задихатися
shrubs	кущі
abide	дотримуватися
creeper	ліана
exploit	подвиг
blot	промочити
ignoble	ганебний
constrain	затримати
cross	протидіяти
startled	вражений
animated	жвавий
struck	вражати
explosive	запальний
explode	розлютитися
toss	підкидати
suave	ввічливий
assessment	судження
bearing	відношення
rub	терти
accolade	нагорода
avenge	мстити
reminisce	згадувати
bottle of vintage	пляшка марочного
provisional	тимчасовий
grievance	образа
unruffled	незворушний
discreet	стриманий
bring matters to a head	довести до ума
formidable	нездоланний
premise	приміщення
scud	мчати
dismal	похмурий
vigil	варта
ken	кругозір
emanate	походити
knuckle	суглоб пальця
horny	мозолястий
ivy	плющ
agility	спритність
sure of foot and firm of grasp	впевнена хода і міцна хватка
amusement	забава
deliberately	навмисно
pebbles	камінчики
prod	тикати
flick	змахнути
impassive	спокійний
dignity	гідність
rattle	деренчати
savage	лютий
shrill falsetto	верескливий пронизливий фальцет
fang	ікло
uproar	галас
dress his torn throat	перев'язати його розірване горло
carotid artery	сонна артерія
hemorrhage	крововилив
take stock of situation	оцінити ситуацію
confine	обмежувати
recurrence	рецидив
phial	флакон
hypodermic syringe	підшкірний шприц
crabbled	нерозбірливо
esteem	поважати
enjoin	наказувати
serum	сироватка
revelation	вияв
strive	прагнути
impatious	нетерплячий
muse	розмірковувати
cesspool	вигрібна яма
pastime	забавка
stowaway	безбілетний пасажир
futile	нікчемний
pathetic	жалюгідний
quack	знахар
soiled	брудний
competence	достаток
treacherous	віроломний
fickle	мінливий
virtue	чеснота
understudy	дублювати
by all means	неодмінно
gaunt	худорлявий
wreath	виток
acrid	їдкий
halt	зупинка
transfix	простромити
haven	притулок
inferior	підлеглий
patrician	вельможа
penurious	нужденний
mottle	цяткувати
lichen	лишайник
lounger	ледар
weakling	слабак
taper	звужуватися (на конус)
spindle	робитися довгим і тонким
locks	волосся
fierce	лютий
eager	нетерплячий
run to seed	занепадати
decent	пристойний
slatterly	недбало
remedy	виправляти
dingy	брудний
pamper	балувати
burden	тягар
produce	показувати
arresting	захоплюючий (привабливий)
securities	цінні папери
dispose	розпоряджатися
plunder	грабувати
fugitive	втікач
brood	роздумувати
tempest	буря
dart	кидати
obtrude	висовувати
greengrocer	продавець овочів
miser	скнара
exacting	вимогливий
betimes	заздалегідь
crumbs	крихти
dismiss	звільнити
be on hand	бути під рукою
grave	серйозний
aloof	віддалік
preoccupied	заклопотаний
austere	суворий
vicarage	будинок священика
vicar	парафіяльний священик
crisis	переломний момент
by no means	ні в якому разі
assume	припустити
stern	суворий
aspect	вигляд
bolted	втік
branch line	відгалуження
futility	даремність
sullen	похмурий
sardonic 	уїдливий
solemn	урочистий
forgery	підробка
unwittingly	мимоволі
condemn	засуджувати
deserve 	заслуговувати
grumble	бурчати
clamor	галасливо висловлювати протест
malevolent scowl	злобний погляд
strain	напружувати
hoarse	хрипкий
claw	жадібно хапати
bird of prey	хижий птах
misshapen	спотворений
pellet	таблетка
takiturn	мовчазний
ill-omened	зловісний
lament	нарікати
irregular	недозволений
compulsory	обов'язковий
virtually	практично
confession	зізнання
sore	біль
efface	стирати
cellar	льох
enterprising	заповзятливий
scaffold	ешафот
invaluable	безцінний
throughout	на всьому протязі
insight	розуміння
wretched	нещасний
niggard	скупий
scheming	підступний
frantic	несамовитий
certainty	впевненість 
halt	вагатися
inference	висновок
conseal	приховати
initial	початковий
box office	касові збори
chart	графік
ascertain	з'ясувати 
astute	проникливий
summon	закликати
miscarriage	невдача
awe	благоговіння
burgle	взлом
skirting	плінтус
tap	кран
plaster	штукатурка
chamber	камера
decoy	приманка
dawn	світанок
spectacles	окуляри
foregathering	зустріч
foul play	нечесна гра
indelible	незмивний
poor devil	бідолаха
bond	облігації
elope	втекти
relent	змиритися
plunder	здобич
swank	вихваляння
workmanlike	майстерний
concluded	заключний
acumen	кмітливість
bold	жирний
kennel	буда
missappropriation	незаконне привласнення
pop out	вискочити
splice	зрощувати
mantelpiece	камінна полиця
neat	акуратний
sleeve	рукав
cuff	манжет
sinewy	жилавий
forearm	передпліччя
scar	шрам
reconcile	примиритися
swell	розбухати
consciousness	свідомість
conscience	совість
vow	обітниця
nonchalant	безтурботний
extraordinary	надзвичайний
diffident	невпевнений
exasperation	роздратування
deliberation	неквапливість
solution	розчин
brusquely	різко
strain	навантаження 
vehemence	шаленство
transcend	перевершувати
earnestly	гаряче
morbid	згубний
endow	наділяти
lean	спиратися
relish	отримувати задоволення
abstruse	малозрозумілий
intricate	заплутаний
dispense	дозувати
dispense from	відмовитися від
abhor	ненавидіти
crave	жадати
cordially	сердечно
exaltation	збудження
tinge	забарвлювати
remonstrate	протестувати
tamper with	підробити
suppress	замовчувати
didactic	повчальний
underlay	лежати в основі
will	заповіт
brier root	корінь шиповника
suggest	пропонувати
acknowledge	виявляти вдячність
cumpled	зім'ятий 
profusion	надмірність
testify	засвідчити
ardent	палкий
fluff	пух
cabbage	капуста
minutiae	дрібниці
preserver	хранитель
impress	відбиток
slater	покрівельник
weaver	ткач
antecedents	минуле
imply	означати
wreaths	завитки
superfluous	зайвий
mold	земля
adhere	дотримуватися
instep	середина стопи
tread	вступити
impertinent	нахабний
submit	представити
crestfallen	зажурений
snap	клацнути
rob	відбирати
barren	безплідний
lustre	блиск
descend	переходити
prospect	перспектива
limp	кульгати
balance of probability	ступінь вірогідності
inference	висновок
dint	робити вм'ятину
interference	втручання
cavalierly	безцеремонно
feat	фах
pinpoint	вістря булавки
transpose	перемістити
redeem	викупити
pledge	застава
groove	канава
wind	накручувати
hence	отже
dreary	похмурий
dismal	гнітючий
unprofitable	марний
swirl	завихрюватися
exert	виявляти
composure	самовладання
dainty	вишуканий
gloved	в рукавичках
plainness	простота
means	засоби
sombre	темний
braid	заплітати
unbraided	не обшитий тасьмою
suspicion	натяк
amiable	доброзичливий
singularly spiritual	незвичайно одухотворений
refined	вишуканий
complexion	колір лиця
can not but	Я не можу не
agitation	збентеженння
utterly	повністю
glisten	блищати
brisk	жвавий
lean	нахилитися
detain	затримувати
relapse	повторення
etstablishment	заклад
boarding	інтернат
in charge of	відповідальний за
infantry	піхота
singular	винятковий
append	прикріпляти
capacity	посада
lustrous	блискучий
enclose	вкладати
pronounce	огоолошувати
particular	старанний
stationery	канцтовари
fervent	завзятий
brisk	жвавий
disguised	замаскований (переодягнений)
twirl	вертіти
resemblance	схожість
speck	цятка
bias	упередженність
antagonistic	протидіючий
repellent	відразливий
disprove	спростувати
legible	розбірливий
vacillation	коливання
self esteem	зарозумілість
martyrdom	мучеництво
daring	сміливий
speculation	міркування
plunge	занурюватися
treatise	трактат
eager	енергійний
fit	припадок
obtuse	тупий
heir	спадкоємець
pensively	замислено
muffle	кутати
cloak	плащ
composed	спокійний
enterprise	справа
embark	починати
faded	бляклий
intently	зосереджено
droop over	опускатися
mistry	загадковий
splotch	пляма
feeble	слабкий
glimmer	мерехтіння
slimy	слизький
murky	мутний
thoroughfare	вулиця із жвавим рухом тр-ту
eerie	моторошний
haggard	виснажений
flit	рухатися швидко і легко
merry	веселий
gloom	темрява
petty	дрібний
jot	записати
memoranda	пам'ятна записка
beshawled	закутаний в шарф
bediamonded	в діамантах
rendezvous	побачення
accost	звертатися
parties	сторони
dogged	упертий
shrill	пронизливий
street arab	пошарпана бездомна вулична дитина
plunge	помчати
errand	доручення
hoax	обман
demeanor	манера поведінки
collected	зібраний
involved	заплутаний
bearing	орієнтація
dash	мчати
tortuous	звивистий
forbidding	відразливий
tawdry	крикливий
staring	що кидається в очі
interminable	нескінченний
draw up	зупинятися
incongruous	невідповідний
Oriental	східний
commonplace	звичайний
piping	писклявий
adolescence	підлітковий вік
trespasser	порушник
sordid	брудний
fir-tree	ялина
jerk	сіпатися
scowl	хмуритися
repose	спокій
pendulous	звисаючий
strive	старатися
feebly	слабко
obtrusive	виступаючий
howl	вити
astonish	дивувати
tapestrie	гобелен
amber	янтар
hookah	кальян
athwart	поперек
airily	весело
unwarranted	необгрунтований
refrain	утримуватися
strain	надрив
callous	безсердечний
settee	диван
inquiry	розпитувати
taper	вощений гніт
discretion	обережність
retiring	схильний до самітності
shrink from	ухилятися від
genuine	справжній
connoisseur	знавець
partial	небайдужий
positive	безсумнівний
aversion	відраза
canvassing	агітація
faint	зомлівати
spleen	селезінка
prop	підпирати
beseech	благати
either	обидва
subside	меншати
greed	жадібність
avarice	скупість
bias	упередженість
superlative	найвищий ступінь
thaw	відлига
thaw	танути
admit	впускати
paroxysm	напад
dusky	смуглявий
stoop over	нахилятися
gash	поріз
ponder	розмірковувати
steal in	пробиратися
bolt	зачиняти на засув
none the wiser	і кінці в воду
dispose of	позбутися
clunge	чіплятися
restitution	відшкодування
malevolence	недоброзичливість
conjure	чаклувати
conjure up	викликати в уяві
rifle	ограбити
haunt	переслідувати
rally	зібратися
carafe	графин
spawn	нереститися
poacher	браконьєр
gall bladder	жовчний міхур
embark	починати
strenuous	напружений
trek	похід
cub	щеня
lush	пишний
modest	помірний
yield	улов
sediment	осад
sparsely populated	малонаселений
abound	рясніти
shroud	закутувати
reindeer herds	стада північних оленів
privation	злидні
hectic	метушливий
jowl	щелепа
ferocity	лютість
cosily	затишно
sinew	сухожилля
yarn	нитка
germs	мікроби
antrax	сибірська виразка
strangling	удушення
shudder	здригатися
robust	надійний
encompass	охоплювати
teem	кишіти
rugged	нерівний
pristine	незайманий
rip up	розривати
hoof	копито
alder	вільха
calf	теля
roam	тинятися
exertion	зусилля
boar	кабан
roe deer	косуля
red deer	благородний олень
contest	змагатися
inundation	наплив
bragging rights	хвастощі
rivalry	суперництво
perish	гинути
daunt	лякати
take its toll	взяти своє
toll	мито
Lighten up!	Рослабся!
starting lineup	стартовий склад
chicken pox	вітрянка
sieve	сито
rehearse	репетирувати
nerve	нахабство
elude	ухилятися
I get shoes.	Я розумію що відбувається
fugitive	втікач
uptight	напружений
rot	гнити
janitor	вахтер
lousy	паршиво
feud	ворогувати
issue	випуск
booth	будка
yuck	гидота
negate	заперечувати
ternary	потрійний
starch	крохмаль
thrift shop	комісійний магазин
let on	видати
laundromat	пральня самообслуговування
blizzard	хуртовина
lounge	кімната відпочинку
hand on to each other	триматися одне за одного
deaf	глухий
venture a guess	ризикнути припустити
dance to	to dance to
slugger	відбитий
chop firewood	рубати дрова
How come?	Як так?
bug	підслуховувати
safety pin	безпечна шпилька
contribute	сприяти
cut	ігнорувати
subhuman	недолюдина
get mugged	бути пограбованим
stand	витримати
after all	все таки
You are certifiable.	Тобі можна поставити діагноз.
walnut casserole	горіхова запіканка
stalk	стебло
celery	селера
seduce	спокушати
decay	занепадати
pantyhose	колготки
intermission	антракт
phony	обман
I have been framed.	Мене підставили.
jello molds	формочки для желе
commit yourself	взяти на себе зобов'язання
postpone entry	відкласти вступ
admission	вступ
hit the sack	лягати спати
object	заперечувати
scholarship	стипендія
general practitioner	лікар загальної практики
mutilation	каліцтво
so far	досі
gown	сукня
cover tracks	замести сліди
get hold of	заволодіти
academic	теоретичний
fall apart	розвалитися
he knows better than do sth.	він не такий дурний щоб робити що-н.
at large	на волі
sagacity	мудрість
delve	ритися
whereabouts	місцезнаходження
splendor	пишність
chaplet	намисто
persuade	переконувати
destitute	бідний
deprecatingly	зневажливо
scurvy	підло
neat	чіткий
cease	припинити
attire	наряд
spring	пружина
sprang	вистрибнути
peaky	гострий
fragile	крихкий
compel	змушувати
incessantly	безперервно
allowance	надбавка
garret	горище
rafter	кроква
heiress	спадкоємиця
lead	свинець
stammer	заїкатися
downcast	опущений
deaf	глухий
babble	балаканина
interminable	нескінченний
implore	благати
nostrum	ліки від усіх хвороб
jerk	ривок
damp	вологий
rift	розрив
gird	підперезати
was girt round	був оперезаний
clamp	скріпляти
gruff	грубий
grumbling	бурчання
clanking	брязкіт
perplexed	розгублений
inexorable	невблаганний
genially	привітний
wind	звиватися
plunge	зануритися
gloom	морок
ill at ease	не по собі
блиск	спалах
thump	стукіт
shrill whimpering	пронизливе скигління
muffled	приглушений
peer	вдивлятися
cumber	загромаджувати
let mole loose	випустити крота
prospector	старатель
blubber	ревіти
pick fingers	перебирати пальці
sorely	вкрай
pat	погладити
whip out	вихопити
smudge	брудна пляма
tapestry	гобелен
bolt	засув
recoil	відсахнутися
stoop	нахилити
shifty	рухливий
suspend	підвішувати
countenance	обличчя
jar	діяти на нерви
scowl	похмурий вигляд
contortion	спотворення
yield	піддаватися
chamber	кімната
fling	кидатися
stopper	пробка
littered	засмічений
wicker	плетений
trickle	просочуватися
pungent	гострий
tar	дьоготь
lath	лата
litter	підстилка
ghastly	жахливий
inscrutable	незбагненний
twine	шнурок
lashed on	стягнутий
thorn	шип
spew	розбухати
speck	плямочка
wring	скручувати
querulous	жалібний
frenzy	божевілля
stumble	спотикатися
ejaculate	вигукувати
expound	викладати
hinge	завіса
mould	цвіль
sill	підвіконня
heel	п'ята
ally	союзник
crevice	щілина
scale	вилізти
stout	міцний
precept	припис
garret	горище
beam	балка
apex	вершина
trap-door	люк
scarce	ледве
hordid	жахливий
foretell	передбачити
enshrine	закріпити
engross	захопити
plot	сюжет
detract from	відволікати від
instructive	повчальний
off-hand	експромтом
whip out	вихопити
furtive	крадькома
sagacity	мудрість
exerting sagacity	виявляючи мудрість
shire	графство
herring	оселедець
pungent	гострий
rule of three	метод знах. третього невідомого
accredited	загальноприйнятий
clamour	шум
rigor mortis	трупне задубіння
enticing	спокусливий
unhinged	незрозумілий
hinge	навішувати на завіси
drawn	напружений
gingerly	обережно
glaze	тьмяніти
blunt	тупий
inference	висновок
auxiliary	допоміжний
retreat	відступ
stride	крокувати
stout	кремезний
burly	кремезний
twinkle	мерехтіти
swollen	набряклий
puffy	набряклий
palpitate	тремтіти
muffle	приглушити
husky	хрипкий
warren	кролятник
wheeze	хрипіти
own up	відверто зізнаватися
hit the nail on the head	влучити в точку
sill	підвіконня
fit	припадок
splinter	осколок
exult	радіти
crestfall	падати духом
concern	стосуватися
snapped	огризнувся
worn away	зношений
coarse sole	груба підошва
sneer	насміхатися
succession	послідовність
mare's nest	гніздо кобили
barel	бочка
placid	спокійний
faint	мліти
sorely	болісно
conventionality	умовність
disadvantage	ставити в невигідне становище
obtrude	нав'язуватися
waist	талія
I stole a glance back	Я крадькома озирнувся
tranquil	спокійний
rod	прутень
stained glass	вітражне скло
accompaniment	супровід
chart	карта
endow	наділяти
fellow lodger	одноквартирант
shabby	поношений
glint	блиск
vagabond	бродяга
mongrel	дворняжка
blossom	цвітіння
kick a row	влаштувати скандал
kennel	псарня
viper	гадюка
slam	грюкнути
unbar	відчиняти
lean	худий
lanky	довгов'язий
stoop	сутулитися
stringy	волокнистий
keep clear of	триматися подалі від
badger	борсук
take a nip	куснути
stoat	горностай
carnivorous	м'ясоїдний
slow worm	веретільниця ламка
fang	ікло
hain't	немає
guy	виставляти на посміховище
lane	провулок
knock up	розбудити стуком
peep	заглядати
cranny	щілина
fowl	птиця
solemn	пихатий
lurcher	шукач
clumsy	незграбний
waddle	перевалюватися
waddling gait	хода, що перевалюється
seal	скріпляти
lump	грудка
struck	вдарити
accessory	співучасник
recline	відкидатися
drape	накинути
clamber	лазати
cramp	стискати
tarry	смолистий
glow-worm	жук-світляк
ridge	гребінь гори
scuffling of feet	човгання ніг
tiles	плитка
pouch	гаманець
wowen out	витканий
tawdry beads	дешевий бісер
string	нанизувати
strung	нанизаний
spine	голка
prick	колоти
connoisseur	знавець
before long	незабаром
tremulous	тремтячий
trudge	довгий важкий шлях
leash	повідець
patter	тарабанити
forlorn	занедбаний
trenche	траншея
crevice	щілина
reflect on	обдумувати
appease	вгамовувати
swerve	збочувати
waddle	перевалюватися
pungent	гострий
contend	суперничати
culpable	винний
palpable	відчутний на дотик
marvel at	дивуватися
means	засоби
patent	явний
above board	чесний
in behalf of	від імені
sequel	продовження
wrong	скривдити
concise	лаконічний
tame	приручити
deceiving	обманливий
so to speak	так би мовити
flunk	провал
blare	рев
picky	вибагливий
exceedingly	надзвичайно
excessively	надмірно
buttocks	сідниці
derogatory	принизливий
pivot	крутитися
prat	сідниці
butler	дворецький
frenzy	божевілля
lest	щоб не
memento	пам'ятка
slay	вбити
conceit	пиха
afford indications	надати показання
confederate	союзник
utterly	повністю
get over it	подолати це
casket	шкатулка
gimmick	трюк
refuge	притулок
magpie	сорока
trample	топтати
alluvial	намивний
silt	мул
aisle	прохід між рядами в церкві
sturdy	міцний
purveyor	постачальник
sustenance	харчування
hubris	зарозумілість
arrogance	arrogance
remittance	грошовий переказ
smuggler	контрабандист
skiper	капітан команди
keep on	продовжувати
envy	заздрість
substitute	заміна
attire	наряд
designated	призначений
diaphanous	прозорий
brassiere	бюстгальтер
credentials	посвідчення особи
breach	порушення
intimidate	залякувати
homeroom	класна кімната
be rattling people out 	розкривати людей
grown up	дорослий
start a fad	почати моду
revolting	огидний
gullible	легковірний
doof	дурість
doofus	дурак
testicles	яєчка
retaliate	відплатити тим же
playbook	п'єса
thrilled	в захваті
ought not to	не повинен
dimwitted	тупий
tater tots	картопляні крокети
hobo	бродяга
dissociation	роз'єднання
elong	подовжити
brat	нахаба
It's been around a while.	Минуло трохи часу.
be around	бути поруч
condemn	засуджувати
remedy	виправляти
You have the floor.	Ви маєте слово.
special ed	спец.вид
admire	захоплюватися
boldly apply	сміливо застосовувати
detest	ненавидіти
sew shut	зашити
recess	перерва в роботі
wreck	крах
morbid	хворобливий
brag	хвалитися
ban is lifted	заборона знята
fudge	вигадка
brisket	грудинка
dodge	ухилятися
shrimp	креветка
shrimp	ловити креветок
chase away	проганяти
lavatory	убиральня
Convenience store	Продовольчий магазин
itty bitty	малесенький
bifurcate	роздвоюватися
resourcefulness	винахідливість
encounter	зустріч
mitigate	пом'якшувати
loose	просторий
mee-maw	бабуся
affectionate	пестливий
nickel	монета в п'ять центів
bran	висівки
attaboy	молодець
fold	складати
firecracker	петарда
stiff	цупкий
stiff	вбити
odds	шанси
numbness	оніміння
scramble	робити яєчню
lap	на колінах
poach	робити яєчню-пашот
bet dollars to donuts	майже напевне
dumplings	пельмені
precautionary	запобіжний
you bet	будьте впевнені
sincerely	щиро
Dang it!	Чорт!
I was over it	Я пережив це
dairy	молочний
borrow	позичати
minor	незначний
rascal	негідник
bail	застава
forgo	відмовитися
keel over	перекидатися
kaboom	бабах
prescribe	призначати
ribs	ребра
stockpile	запасатися
my brush with death	моє зіткнення зі смертю
ebb	згасати
raspy	хрипкий
canned	консервований
spit	плювати
a scoop of soup	черпак супу
gravy	соус
pork chop	свиняча відбивна
fragile	крихкий
bendy straw	гнучка солома
whir	гудіння
Coming up.	На підході.
slurp	сьорбати
he is wasting away	він марніє
coddle	розпещувати
shrink	психіатр або психолог (неформ)
constipation	запор
right on	правильно
gabble	базікати
onomatopoeia	звуконаслідування
diaper	підгузник
help yourself	Пригощайтеся!
button fly pants	штани з ґудзиками
estuary	лиман
corduroy	вельвет
potbelly stove	буржуйка
fuzz on peaches	пух на персиках
nag	набридати
obscure	незрозумілий
went right over their heads	залишилося незрозумілим
Geez!	Боже!
offensive	образливий
allot	виділяти
punt	подавати м'яч ногою
Never you mind.	Забудь.
tuck	підтикати ковдру
tousle	куйовдити
bosom	жіночі груди
affectionate	приязний
knock around	байдикувати
You are grounded.	Ти наказаний.
time crunch	нехватка часу
outstanding	несплачений
sass	зухвало перечити
inhibition	заборона
cutting loose	відриватися
it is knocking me for a loop	це збиває мене з толку
wind up	завершувати
employ	застосовувати
extricate	виплутувати
tattle	пробовкнутися
dapper	ошатно одягнений
scoop	черпати
versatile	різнобічний
shin	гомілка
freshman	першокурсник
boldly go	сміливо йди
nincompoop	дурник
deterioration	погіршення
squat	незаконно заселене місце
vault	сховище
tantrum	істерика
let it slide	пропустити мимо уваги
sufficient equity	достатній власний капітал
favourable terms	вигідні умови
tread lightly	діяти обережно
prone	схильний
meltdown	крах
keep putting up	продовжувати миритися
loopy	дивакуватий
humiliate	принижувати
grind to a halt	зупинятися
tummy	животик
ulcer	виразка
leprosy	проказа
gout	подагра
mad cow	коров'ячий сказ
out of spite	на зло
for the time being	в даний час
mend	поліпшення
straighten this thing	виправити цю річ
carsick	закачувати
exert	напружувати
pitchover	переворот
dispersion	розсівання
catch up	наздоганяти
contemplate	міркувати
stuck up for me	заступився за мене
Joe Sixpack	звичайний типовий робочий
You bet.	Будьте впевнені.
poke	вишукувати
knock off	швидко зробити
brisket	грудинка
spit	плюватися
anticipation	очікування
Gee!	Ну!
one of these days	коли-небуть
tubby	товстий
slab	кусок
cannonball	гарматне ядро
boobie	олух
eavesdrop	підслуховувати
heap	купа
whipped	збитий
cranky	капризний
dope	дурак
feud	ворожнеча
stubborn	упертий
ckricket	цвіркун
chirp	цвірінькати
embark	починати
see fit	вважати за потрібне
doomed	приречений
rub	натирання
ground coffee	мелена кава
baste	поливати страву
spritzing	бризкання
tend	доглядати
chicory	цикорій
soggy	мокрий
hold in low	недовіряти
grunt	бурчати
cumin	кмин
tablespoon	столова ложка
potty training	привчання до горщика
knock up	підбивати
maiden	перший
fellowship	товариство
laterally	збоку
lateral	бічний
bonker	божевільний
squirm	звиватися
gurgle	булькати
reconcile	примирити
in vain	марно
spring that on me	скинути це на мене
oddball	дивак
pal	приятель
piddle	мочитися
catch on	встигати розуміти
clog	забивати
have crush on	закохатися в
allowance	кишенькові гроші
spacecraft	космічний корабель
pinky swear	клятва на мізинчиках
up and at'em	вставай і дій
Shotgun!	Я на передньому!
mandatory	обов'язковий
mediocrity	посередність
armadillo	броненосець
expel	витісняти
twitch	смикатися
cracle	потріскувати
hoot	кумедний
placate	заспокоювати
compassion	співчуття
concrete	конкретний
graspable	зрозумілий
splendid	чудовий
mean	підлий
break wind	вивільняти гази
mock	знущатися
term	умова
console	втішати
regardless	вже не говорячи про те, що
plush	плюшевий
high and mighty	зарозумілий
be cut out for	бути створеним для
tutor	репетитор
tough	важко
obstruction	перешкода
simpleton	простак
conundrum	загадка
indubitably	безсумнівно
ankles	щиколотки
get along	ладити
hernia	грижа
bowel	кишечник
dupe	обдурити
embolden	підбадьорювати
lunatic	божевільний
transgression	проступок
relinquish	поступатися
gal	дівчина
pop	тріск
swoopy	розмашистий
forge	кувати
make amends	загладжувати провину
deli	гастроном
bat for him	битися за нього
wee	крихітний
tossed around	крутилося
turn this down	відхилити цю пропозицію
assess	оцінити
hilarious	веселий
living arrangements	умови проживання
tingle	мурашки поколюють
chuckle	сміятися
family lore	сімейні передання
weep	плакати
accommodating	поступливий
hit it off	ладити
filthy	брудний
heirloom	реліквія
cherish	дорожити
wept	плакав
impend	загрожувати
tense	напружений
dig in	встромляти
decapitate	обезголовити
drift off	дрейфувати
haunted	переслідуваний
dumbbell	дурак
lord	володар
gray matter	сіра речовина
chute	жолоб
dagger	кинджал
dungeon	підземелля
summon	викликати
pitchfork	вила
incantation	заклинання
wound up	заводитися
locked and loaded	готовий до дій
jackass	осел
amuse	тішити
at stake	на кону
come over	підійди
You had that one coming.	Ти на це заслужив.
purview	компетенція
root and stem	корінь і стебло
pushback	відсіч
notion	поняття
gospel	євангеліє
suck up	підлизуватися
noggin	макітра
terrific	приголомшливо
quail	перепілка
pointy	загострений
every once in awhile	час від часу
confess sins	визнавати гріхи
let's not bring that up	давайте не згадувати це
Howdy	привіт
help out	виручити
nibble	гризти
get a kick out	отримати кайф
commandment	заповідь
drool	пускати слину
chickenpox	вітрянка
convert	навертати
feasible	можливо
alleviate	полегшувати
adultery	подружня зрада
culpability	винуватість
heinous	огидний
remorse	каяття
repent	каятися
redemption	викуп
beam	спрямовувати
snazzy	шикарний
floor model	виставкова модель
insult	ображати
pumpkin	гарбуз
meddle	втручатися
set aside	відкладати
seamstress	швачка
that was uncalled for	це було непотрібним
earmuffs	навушники для слуху
almanac	щорічник
exhale	видихати
tiff	незлагода
blow over	минати
earmark	відмітна ознака
subtext	підтекст
inconvenience	створювати незручності
spat	незлагода
bowl of cereal	миска пластівців
occasional meat	час від часу м'ясо
occasional	несподіваний
affection	прихильність
inanimate	неживий
lousy	паршивий
elaborate	розвивати
darn tootin'	чорт забирай
decomposition	розкладання
substitute	замінити
spin-off	побічний продукт
prodigy	вундеркінд
nasal irritant	подразник носа
simile	порівняння
detention	затримання
whip	шмагати
whup	стукати
paddle	весло
spank	лупцювати
consent	згода
whack	вдарити
act up	капризувати
slab	плита
roomful	повна кімната
hoodlum	хуліган
mug	грабувати
badass	пиздатий
horseplay	грубі жарти
tickle	лоскотати
suspended	призупинений
bartender	бармен
rickets	рахіт
early-onset	ранній початок
rabies	сказ
achy	болить
sore	хворий
runny nose	нежить
influensa	грип
strain	штам
wrap this up	завершити це
buffet	наносити удари
hedge	живопліт
chores	домашні справи
prairie	прерія
due	належний
go potty	ходити на горщик
sink	раковина
feces	фекалії
lure	заманювати
take a crack	спробувати
whack off a head	відбити голову
rattlesnake	гримуча змія
albeit	хоча
mucus	слиз
silver lining	промінь надії
congestion	затор
elaborate	розвивати
potluck	фуршет
under the counter	під прилавком
fat chance	без шансів
in the prime of life	у розквіті сил
coddle	розпещувати
sissy	мамин синочок
step up	активізувати
peruse	уважно читати
right as rain	повністю в порядку
have a peak	зазирнути
affliction	страждання
befall	випадати на долю
reign supreme	верховно панувати
scrape	дряпати
splinter	скалка
tweezer	пінцет
throb	пульсувати
gauze	марля
pluck	общипувати
naughty	неслухняний
latchkey	відмичка
lend an ear	вислухати
whatnot	всяка всячина
numb	онімілий
well-to-do	заможний
light-headed	запаморочення
endide	закінчувати
toddle	вчитися ходити
toddler	дитина, яка починає ходити
broomstick	мітла
locker room	роздягальня
spirited	бадьорий
sophistication	витонченість
sweatshirt	спортивний светр
entertain	розважати
major	спеціалізуватися
dog	самець
creepy	жахливо
sedimentary	осадовий
rapport	взаєморозуміння
seduce	спокушати
ravine	яр
resemblance	схожість
gypsum	гіпс
cleavage	розкол
dorm	гуртожиток
bladder	сечовий міхур
too-in-your-face	занадто нав'язливо
commuter	пасажир
unbridled	незагнузданий
bubble up	іти бульбашками
possessed	одержимий
channel	спрямовувати в русло
vertigo	запаморочення
step stool	стілець
stubborn	упертий
trepidation	трепет
hint	натякати
baloney	дурниця
gymnasium	гімнастичний зал
neatly	акуратно
fiddle-faddle	дурниці
poodle poop	кал пуделя
claw	дерти кігтями
tie	нічия
disillusioned	розчарований
sign off	оголошувати кінець
frizzy	кучерявий
spank	відшльопати
firm	міцний
scratchers	лотерейний білет
disenchanted	розчарований
odd	чудний
come on by	заходь
have a hang on it	мати навик
off-putting	відштовхуючий
intercepted	перехоплено
razzamatazz	ефектність
broach	брошка
freak	виродок
Break a leg!	Хорошого виступу!
wretches	нещасні
bide	терпіти
pelting	шалений
ragged	драний
daisies	ромашки
pasture	пасовище
stage fright	страх сцени
full-blown	повноцінний
knuckle	суглоб пальця
pipe down	замовкнути
compelling	переконливий
adversarial	ворожий
interrogation	допит
fyi	до відома
prosecute	притягувати до відповідальності
prosecutor	прокурор
late bloomer	пізньоцвіт
take after someone	бути схожим на когось
martial	військовий
pant	задихатися
bowl	грати у боулінг
sore	болить
roughhouse	хуліганити
rustle	шелестіти
pop	тріск
they will take it out of him	вони відіграються на ньому
Got it covered	Зрозуміло
pick on someone	приставати до когось
cover for	покривати
annoying	докучливий
tadpole	пуголовок
tuck	заправляти
intimidate	залякувати
dump	купа
holier	святіший
pick on someone	приставати до когось
pine	сосна
tripp	спотикатися
newshound	репортер
cluck	кудкудакати
no-brainer	легке завдання
coop	курник
lumpy	грудкуватий
mate	жінка
take swing at	замахнутися на
perilous	небезпечний
soaking wet	наскрізь мокрий
diminutive	зменшувальний іменник
mascot	талісман
demeanor (US)	поведінка
demeanour (UK)	поведінка
mint chip	м'ятне морозиво
perturbate	збурювати
barn	сарай
subtle	витончений
sacrilegious	святотатство
put that off	відкладати
I'm digging it	мені це подобається
consent	згода
maroon	бордовий
meatloaf	м'ясний рулет
scholarship	стипендія
50$ a pop	50 доларів за штуку
feast	тішитися
mitigate	пом'якшити
spare	щадити
accommodate	пристосовуватися
stoker	кочегар
pen pals	друзі по листуванню
get situated	розташуватися
double basket weave	подвійне кошикове плетіння
knit	в'язати
loom	ткацький верстат
apron	фартух
penmanship	почерк
corneas and irises	рогівки та райдужки
excited	схвильований
Pillsbury Doughboy	добре приготований вареник
courtship	залицяння
appealing	привабливий
run out of room	закінчилося місце
disclosure	розкриття
settle down	заспокоюватися
reciprocated	взаємно
dodge a bullet	ухилятися від кулі
jingle bell	дзвіночок
glint off	відблискувати
by all means	неодмінно
decept	обманювати
infantry	піхота
recon	розвідувати
acceleration due to gravity	прискорення за рахунок сили тяжіння
wander around	бродити навколо
repulsive	відразливий
cut crusts	зрізати скоринки
gated community	закрите селище
he is teething	у нього ріжуться зуби
gum	жувати яснами
dizzy	запаморочення
chamomile	ромашка
mutt	дворняга
stir	перемішати
gerbil	піщанка
apparently	мабуть
He pushed in a screen window.	Він штовхнув сітку від комах.
rodent	гризун
immaculate	бездоганний
lure	заманювати
self righteous	лицемірний
coward	боягуз
challenging	складний
infer	робити висновок
terrific	приголомшливо
belly button lint	ворсинки пупка
cynophobia	кінофобія
basic premise	основна передумова
she is not crazy about you either	вона і від тебе не в захваті
parishioner	парафіянин
particularly	особливо
Beats me.	Не знаю.
slammer	в'язниця
mesmerising	заворожучий
condemn	засуджувати
sip	малий ковток
surf meets the turf	прибій зустрічається з дерном
You got it.	Ти це отримав.
bib	верхня частина фартуха
chunk	шматок
pant leg	штанина
breaststroke	брас
delightful	чудово
O gauge	колія у масштабі букви О
entice	заманювати
infer	робити висновок
By all means	У всіх сенсах
role model	зразок для наслідування
thrilled	в захваті
look up to	рівнятися на
bottled up	тримати в собі
underfoot	під ногами
conducive	сприятливий
I chipped a tooth on a peach pit.	Я відколов зуб персиковою кісточкою.
wok	китайська сковорода вок
trick	секрет
turd	гівно
preemie	недоношений
brace	скоба
stuck up	зазнаватися
different tack	інша тактика
sleepover	ночівля
take a page	наслідувати чиюсь поведінку
mean barbecue	виключно прекрасне барбекю
little family over	мале родинне зібрання
utencil	посуд
rival	суперник
peril	ризик
teem	кишіти
integral part	невід'ємна частина
garlic	часник
burps	відрижки
agitated	схвильований
peas pod	стручок гороху
hamstring	підколінне сухожилля
machismo	мужність
trimmings	обрізки
prude	скромний
it askew in my groin	воно перекосилося в моєму паху
playing the field	зустрічатися з обома одночасно
bagels	рогалики
tougher	важче
it's the other way around	це навпаки
guilted and embossed paper	стьобаний і тиснений папір
brillo pad	металевий йоршик
dinette set	обідній набір меблів
derriere	сідниці
beholden	зобов'язаний
expansion leaf	лист розширення (столу)
mourn	оплакувати
lovesick	закоханий
I had to look that one up.	Мені довелося шукати це.
exhilarating	хвилюючий
chivalrous	лицарський
epiphany	Богоявлення
ambiguity	двозначність
notary	нотаріус
vengeance	помста
cinnamon	кориця
slip	висковсувати
cutlery	ножові столові прилади
wrestle	боротися
hum	гул
skin crawl	мурашки по шкірі
disembowel	випотрошити
mysterious	таємничий
giggle	хихикати
He wouldn't listen.	Він не хотів слухати.
needy	нужденний
quivering	тремтячий
stain	пляма
damned spot	прокляте місце
rumble	гуркотіти
tangle	вв'язуватися в конфлікт
reap	пожинати
customary	загальноприйнятий
brave the elements	боротися зі стихією
mug	кухоль
lounge	кімната відпочинку
bench a linebreaker	садити захисника на лаву
flunk	провалити
locker room	роздягальня
neck	шия
coloquial	розмовний
foible	слабкість
depreciate	знецінювати
hinge on	залежати від
derive	вивести
octet	група з 8 елементів або людей
uterus	матка
knot	вузол
rule out	виключити
relate	стосуватися
to be winging it	удавати
squeal	пищати
sac	мішечок
blow a raspberry	ффукати на язика
excruciating	нестерпний
excruciate	мучити
flatly	однозначно
brewing	пивоваріння
belt buckle	пряжка ременя
binder clip	зажим для бумаг
crooked	кривий
dumb down	тупити
spelling bee contest	правописний конкурс
make out	замутити
grab a straw	хапатися за соломинку
sermon	проповідь
hangover	похмілля
nail this down	закріпити це
growl	гарчати
precious	дорогоцінний
slugger	відбиваючий (гравець)
clothing drive	збирати одяг на благодійність
big time	наголошення на важливості
lullaby	колискова
backfire	зворотний ефект
warp	викривлення
you are most welcome	прошу дуже
sniff	сопіти
beverage	напій
heck yeah	чорт забирай так
cocky	зухвалий
casserole	запіканка
contagious	заразний
ticks	кліщі
share credit	ділитися заслугами
ambiguous	неоднозначний
be cool	будь спокійним
six-pack	упаковка шести банок пива
abrupt	раптовий
interjection	вставне слово
expenditures	витрати
write that off	списати це
miscellaneous	різне
peas	горох
intestine	кишечник
bowel	кишечник
colon	товста кишка
bowel movement	дефекація
potty	горщик
hold out	витримати
come clean	говорити правду
rat me out	здати мене
children's rate	дитячий тариф
tickle	лоскотати
sting	жалити
apprehend	затримати
come up	виникати
holler	гукати
gruesome	жахливий
pungent condiment	гостра приправа
raisins	ізюм
zipper	застібка-блискавка
deception	обман
warlord	воєначальник
assume the position	зайняти позицію
sordid	мерзенний
creak	скрипіти
utmost courtesy	гранична ввічливість
grunt	бурчати
gulps	ковтки
bunch	купа
impaired	ослаблений
bail out	виручити
dangle	бовтатися
hanging by a thread	висить на волосині
turn in	іти всередину
he stumbles over to	він натикається на
irrigate	зрошувати
be content to	тішитися
come to pass	збутися
fraternal twins	різнояйцеві близнюки
geez	чорт
poking and prodding	тикання та підштовхування
kids are pitching in	діти беруть участь
bucket	відро
rinse off	змити
generous	щедрий
comb	розчісувати
temper tantrum	істерика
even-keeled	урівноважений
slam the door off its hinge	грюкати, що аж двері злітають
lamb chop	бараняча відбивна
get cracking	поспішити
shrink	зменшуватися
kudos	похвала
tushy	зад
accentuate	акцентувати
buttocks	сідниці
syllogism	умовивід
meter is running	лічильник працює
dignity	достоїнство
get down	Попустись
deprive	позбавляти
poppycock	дурниця
insightful	проникливий
perceptive	сприйнятливий
go figure	піди розберися
fuzzing around	метушиться навколо
blabbermouth	балакун
per diem	добові
prohibition	заборона
encroach	зазіхати
seizures	судоми
ingest	ковтати
excess	надлишок
slough off	відшарувати
cardiac arrests	зупинки серця
fracture	перелом
sludge	осад
swell	набрякати
nausea	нудота
marrow	кістковий мозок
slop	помиї
ominous	зловісний
hoot (inf)	весело
swing	провернути
pillory	позорний стовп
stir up quite a bit controversy	викликати чимало суперечок
wages of sin	заплата за гріх
gruesome	жахливий
call it a night	назвати це ніч
tag (inf)	трохи
scoff	глузувати
chatter	балаканина
flair	чуття
props	реквізит
vividly	яскраво
peril	небезпека
gore	закипіла кров
mount	монтувати
haunted house	будинок з привидами
gluttony	обжерливість
lust	похіть
sloth	лінь
wrath	гнів
greed	жадібність
spooky	моторошний
sincerity and charm	щирість і чарівність
chackle	хихикати і скалити зуби
golly	боже
caw	каркати
wheel and deal	заправляти справи
pick your brain	попросити твоєї поради
fetch	принести
gasp	роззявляти рота
No. Go for it.	Ні. Дій.
unquenchable	незгасимий
clock-full	повнісінький
chock	повністю
eerie	моторошний
cast from	кинути з
bear witness	засвідчувати
come over	підійди
take a ganger	глянути (як гусак тягне шию)
cape	плащ
boatload of converts	човен навернених
glum	похмурий
whimp	скиглити
tawdry	безглуздий
vindication	підтвердження
stuff	напихати
peach cobbler	персиковий пиріг
mullet	зачіска (довга ззаду, кор.спер.)
starfleet	зоряний флот
entitle	давати право
impersonate a lump clay	уособлювати грудку глини
gard sale	гаражна розпродажа
chop down	порубати
sticking point	камінь спотикання
haggle	торгуватися
squat (inf)	нічого
steep	крутий
apiece	кожному
factor that in	врахувати це
You all drive a hard bargain.	З вами важко торгуватися.
wander off	блукати
huddle	натовп
hubby	чоловік
cobbler	фруктовий пиріг
kick this offt	розпочати (like kickstarter)
zippo (slang)	нуль
suit yourself	робіть як вам подобається
fascinating	захоплюючий
humdinger	класний хлопець
hand over fist	спритно
reminiscent	що нагадує
darn	прокляття
confide	довіряти
establish	з'ясовувати
screech	верещати
grunt	бурчати
heartburn	печія
reflux	печія
compassionate	співчутливий
departure	відхилення
covet	жадати
amusing	кумедний
juxtaposition	зіставлення
tickle	лоскотати
snazzy	шикарний
pointy	загострений
you are in charge	ти головний
reckless	безрозсудний
coverall	комбінезон
winded	захеканий
sumbitches	негідники
grease	мастило
purview	сфера компетенції
shut your yap	заткнись
call in sick	заявити про хворобу
I get tackled	Мене схоплюють
slingshot	рогатка
flute	флейта
fibber	вигадник
chitchat	балакати
he is acquired taste	він на любителя
track down	вистежувати
hooky	прогул
offence	правопорушення
thrilled	в захваті
dungeon	підземелля
you are up for it	ви не проти
first-off	По-перше
punture	прокол
scoop him up	зачерпнути його
pull a groin muіcle	потягнути паховий м'яз
goosebumps	мурашки по шкірі
bicentennial	двохсотліття
elective	факультатив
reluctantly	неохоче
have a shot at	спробувати
lippy	наглий
commute	їздити на роботу
I wasn't going to commute	Я не збирався їздити на роботу
pathetic	жалюгідний
I don't think it is in the cards	Я не думаю, що це в планах
thesaurus	словник
crestfallen	занепалий
chagrined	засмучений
mole on my hip	родимка на стегні
club foot	косолапість
wrap it up	загортай це
concur	погоджуватися
reassert	підтверджувати
tin can	жестяна консерва
sputter	бризкання
put your foot down on that	поставити на цьому крапку
pass out	непритомніти
escalate	загострювати
storm out	вийти з обуренням
brutalize	поводитися грубо і жорстоко
astute	проникливий
olfactory	нюховий
I turned it down	Я відмовився від цього
block with new kids on it	квартал із новими дітьми
you will never hear the end of it	тобі до кін.жит.будуть це нагад.
sleeping quarters	спальні приміщення
extra credit	додаткові бали
burp	відрижка
hubba hubba	Ось так так!
crept up	підкрався
creep up	підкрадатися
leave you out of	залишити вас поза
herbivores	травоїдний
misfit	непристосований
stunted childhood	відставання в дитинстві
ample	достатньо
cello	віолончель
I for one	Я наприклад
goof off	дурачитися
horseplay	груба розвага
shenanigan	махінація
maladjusted	непристосований
paraphernalia	атрибутика
rack	стелаж
let me down	підводити мене
wobbly	хиткий
reciprocate	відповідати взаємністю
antic	витівка
madcap prankster	божевільний жартівник
repent	каятися
bidding	розпорядження
simian	мавпячий
repentance	каяття
whir	дзижчати
Got to love him	Треба любити його
savior	рятівник
bass player	басист
skinny dipping	купання голяка
bug	надокучати
cabbage patch	капустянка
trove	скарбниця
dunked	занурений
crank out	провернути
craps table	стіл для гри в кості
heads up	попереджати
randiness	похітливість
clink	дзенькіт
Whip her with a rubber hose?	Відшмагати її гумовим шлангом?
administer	керувати
tricky	хитрий
inflict	заподіювати
dunk	занурювати
wade in the water	бродити у воді
pigtail	косички
jerk	тупиця
fidelity	точність
hence	отже
close call	на волосину від
blister	пухир
scurvy	цинга
fever	лихоманка
quadrilateral	чотирикутник
inscribed	вписаний
cyclic polygon	циклічний багатокутник
groan	стогнати
reprieve	відстрочка
bowel movement	дефекація
effervescent ginger ale	шипучий імбирний ель
flat drink	напій, з якого вже вийшли гази
indulgent	поблажливий
insurgent	повстанський
fuss	метушня
dote on	захоплюватися
it has done right to me	це вчинило правильно для мене
puberty	статеве дозрівання
gallbladder	жовчний міхур
administer	постачати
incision	розріз
snatch	вирвати
snatch out	вихопити
a bowl of gruel	миска кашки
formidable	величезний
doofus	тупий
ridiculous	обурливо
adamant	непохитний
pulp	м'якоть
strain	процідити
contagious	заразний
stall	зупинитися
put up with	миритися
You get my drift?	Ти вловив мою думку?
bang heads together	битися головами
band-aid	пластир
faint	непритомніти
major	більший
chime	дзвонити
celestial	небесний
guilt-ridden	охоплений почуттям провини
lavish	розтринькувати
combustible gas	горючий газ
incinerate	спалювати
supervise	контролювати
receptacle	ємність
hazardous	небезпечний
obligation	зобов'язання
imply	означати
implicitly	неявно
procure	діставати
obscene	непристойний
obliterate	знищувати
splinter	роздробляти
opaque	непрозорий
saucy	зухвалий
camelid	верблюд
camelidae	верблюдові
vicuna	вікунья
That's kind of what I'm getteng at.	Ось, що я маю на увазі.
obtain	отримати
query	запит
curl up	скручуватися
curled up in a ball	згорнувшись у клубок
figment	вигадка
he is just crushed	він просто розчавлений
mediocre	посередній
fricking fascinating	страшенно захоплююче
turned on	збуджений
flat-out erotic	відверта еротика
cool your jets	заспокойтеся
screech	вереск
sediment	осад
defy odds	кинути виклик шансам
intimidation	залякування
threats	погрози
altercation	сварка
confrontation	протистояння
tussle	суперечка
incur your wrath	накликати твій гнів
incur	накликати на себе
punk	нікчемний
hit on my girlfriend	приударити за моєю дівчиною
overly chummy	надмірно дружній
bottom	задниця
plaintiffs	позивачі
lamb	ягня
swipe	красти
blush	рум'янець
dud	невдаха
resent	ображатися
mucus or phlegm	слиз або мокрота
takeaway	головна думка
apparently	мабуть
so much so	настільки
spirited	бадьорий
student body	учнівський колектив
I was no stranger to	мені не було чужим
wind sprint	вітровий спринт
adamant	непохитний
boast	хвалитися
hugs and kisses	
prattle	базікати
cheer	підбадьорювати
brawl	бійка
sling	праща
step down	спуститися
stand up to 	протистояти
inevitably	неминуче
back down	відступати
assault and battery	напад і побиття
I nailed it	Я все правильно зробив
excellence	досконалість
terrific	приголомшливо
don't sweat it	не хвилюйтеся
patootie (slang)	сідниці
permeability	проникність
come down with	захворіти
snatch	вирвати
perky	жвавий
percolator	гейзерна кавоварка
counselling	консультування
convex polygon	опуклий багатокутник
newlyweds	молодята
I'll never know	Я ніколи не дізнаюся
fill in	заміщати
dig=like	подобатися
elaborate	детально розроблений
gingham	ситцевий
wooing	залицяння
dotingly	з любов'ю
nightstand	тумбочка
hunky-dory	славний
bring it on	давай
limp	млявий
diminish	меншати
hackles up	волосся дибом
berating him	дорікаючи йому
jackass	осел
shut-in	лежачий хворий
lose a step	втрачати хватку
impasse	безвихідь
give him a pass	пробач йому
congregation	збір
congregate	збиратися
expel	виштовхувати
rye	жито
Is anybody going to fill me in?	Хтось збирається мене просвітити?
hearth	вогнище
hacksaw	ножівка
sniffle	сопіти носом
womanhood	жіночність
rotten	гнилий
Denmark	Данія
taste buds	смакові рецептори
grab a bite to eat	перекусити
convenient	зручний
convenience store	крамниця
subsidiary	дочірнє підприємство
acquisition	придбання
pastry	випічка
coward	боягуз
fascinating	чарівно
on behalf of	від імені
baker's dozen	чортова дюжина
commie	комуняка
hatch	висиджувати
traitor	зрадник
It will all blow over	Це все пройде
frustrate	розчарувати
get bent out of shape	втратити форму
thanks for having me	дякую, що ти прийняв мене
get ahead of yourself	забігати наперед
behind counter	за прилавком
discreet	стриманий
fertile	родючий
flip out	втратити контроль
set bar high	поставити високу планку
malt liquor	солодовий лікер
highness	високість
pick on you	приставати до вас
zip your feet open	розкривати ноги
How far along are you?	Як далеко ви зайшли?
I was a little thrown too	Мене теж трохи підкинуло
coaster	підстаканник
crochet	вишивати
prowess	доблесть
confine	обмежувати
fiddle	скрипка
wherefore	для чого
be in charge of	бути відповідальним за
emulate	наслідувати
come around	передумати
persuade	переконувати
have to come to love	полюбити
aptitude	здібність
preliminary	попередній
neat	акуратний
pitched a perfect game	показали ідеальну гру
push for this	домагатися цього
conk	вирубатися
well-tended	доглянутий
absentminded	розсіяний
giddy	запаморочення
praying mantis	Богомол
what you up to	що ти задумав
resemble us	схожі на нас
astonishingly	вражаюче
jot down	коротко записати
thimble	наперсток
pooh to you	фу тобі
flint	кремінь
puddle	калюжа
yakking	балаканина
vowel	голосна буква
epiphanies	прозріння
rhubarb	ревінь
rain check	гарантоване повторне запрошення
concussion	струс мозку
decent	славний
beverage	напій
oomph	енергія
saliva	слина
squishy	безструктурний
tackle	приладдя
dummies	манекени
infringe	порушувати
lodge complaint	подати скаргу
school board	шкільна рада
bloodlust	жага крові
serendipitous	щаслива випадковість
run for president	балотуватися в президенти
water off a duck's back	як з гуски вода
a shot of winning	шанс на перемогу
affinity	потяг
impeccable	бездоганний
strand him	висадити його
weak-kneed	легкодухий
retaliate	відплатити тим же
lice	воші
resort to	вдаватися до
decisive	вирішальний
he creeps me out	він лякає мене
hurdle	перешкода
perspiration	пітливість
palpitations	прискорене серцебиття
unleashed	розв'язаний
ventriloquist	черевомовець
gab	балакучість
assembly	зібрання
bladder	сечовий міхур
it dawned on me	мене осяяло
pep	бадьорість
aspire	прагнути
stoop to her level	опуститися до її рівня
treasurer	скарбник
heckling	лайки
whoop	вигук
booing	освистування
pennant	прапорець
cologne	одеколон
olfactory	нюховий
seal	тюлень
communicate his qualities	передати його якості
static cling	статичне прилипання
peachy	чудовий
Popsicle	Ескімо
glitter	блискітки
bring up	піднімати
compatible	сумісний
predecease you	померти раніше вас
dresser	комод
we will get cozy	нам буде затишно
hibiscus tea	чай з каркаде
I get you	я вас розумію
disconcert	бентежити
horse whickering	кінське іржання
put down	опускати
Thanks for stopping by	Дякую, що зайшли
bum	бомж
catch up with	наздоганяти
commitment	зобов'язання
You betcha!	Ще б пак!
pun	каламбур
rough patch	складний час
unconditional	безумовний
perilous	небезпечний
jinx	наврочити
buzzer	дзвінок
impose	нав'язуватися
chamomile	ромашка
nether	нижній
adorable	чарівний
taper off	звужуватися
ace	туз
jukebox	музичний автомат
it is tax deductible	це не оподатковується
deduct	відрахувати
trod	ступати
cranky	вередливий
constitute a problem	складати проблему
strap on some bibs	пов’язати нагрудники
parish	парафія
perish	гинути
prosperous	вдалий
sound	здоровий
spellbinding	зачаровує
starch	крохмаль
his due	належне йому
propagation	поширення
root for	уболівати за
jabbering	лепетання
better yet	ще краще
diuretic	сечогінний
weeding	прополка
spelunking	спелеологія
refreshments	освіжаючі напої
he tripped off an alarm	він ввімкнув сигналізацію
dean	декан
scone	булочка
cereal	зерновий
scuffle	штовханина
startle	здригатися
dickens	бісеня
Keep your shirt on.	Заспокойся.
peculiar	своєрідний
long overdue	давно пора
appropriate	доречний
festivities	урочистості
Not by a long shot	Не надовго
faintly	слабко
room and board	проживання та харчування
neigh	іржати
behoove	належить
premise	приміщення
has concluded its meeting	завершив своє засідання
frenzy	божевілля
prolific	плідний
revolting	противний
contagious	заразний
come up with	придумати
You gotta get in on this	Ти повинен цим зайнятися
roll in	приходити
cheeky	нахабний
impudent	безсоромний
exasperation	роздратування
concession	уступка
strides	поступ
roll in	приходити
he was from the get go	він був з самого початку
she is unraveling	вона сходить з розуму
stocking stuffer	наповнювач панчіх
give a boot	прогнати
preoccupied	заклопотаний
grants wishes	виконує бажання
Are you mental?	Ти усвідомлюєш що ти робиш?
lunatic	божевільний
sled	сани
You're up to speed?	Ти встигаєш?
blindfold	пов'язка на очі
affiliate	філія
amendment	поправка
conjunction	з'єднання
wording	формулювання
toil	трудитися
stoke fire	розпалити вогонь
worship	богослужіння
I was just fixing to head out	Я якраз збирався йти
discharge firearm	розряджати вогнепальну зброю
muskrat	ондатра
matrimony	шлюб
bummer	облом
solution	розчин
homogeneous	однорідний
solute	розчинена речовина
solvent	розчинник
succumb	піддаватися
broom closet	шафа для віників
contribute	вносити
foot rub	розтирання ніг
Whoa	ой
suspenseful	напружений
What prompted it?	Що спонукало до цього?
prompt	підказувати
freshman	першокурсник
juvie	неповнолітній
make stuff up	вигадувати речі
swat	сильний удар
necklace	намисто
dork	дурень
I went out of my way to buy	Я зробив все можливе, щоб купити
we were at odds	ми були в суперечці
whereabouts	місцезнаходження
shroud	ховати
loophole	лазівка
wail	волати
state troopers	державні війська
law enforcement	правоохоронні органи
nodule	вузлик
unified field theory	єдина теорія поля
crayon	олівець
fill up	наповнюватися
snotty	сопливий
if you are off to war	якщо ти йдеш на війну
follow through	виконувати
zip	свист
natural	обдарована людина
pivot	поворот
relative pronoun	відносний займенник
seam	шов
flick	різко змахнути
stitch	шов
definitely	безсумнівно
rectify	виправити
unwind	розмотати
commit	здійснити
thrilled	в захваті
darn	прокляття
they are out front	вони ззовні
stigmatize	таврувати ганьбою
disturbed	збентежений
discharged	виписаний
nightcap	стаканчик спиртного на ніч
growl	ричати
catch	улов
matchmaker	сваха
he has your best interests at heart	він дбає про ваші інтереси
hospitality	гостинність
Here's to surprises.	От до сюрпризів.
spite	на зло
establishment	заклад
acquaintance	знайомий
I am damaged goods.	Я пошкоджений товар.
whimsy	примхливість
woe	горе
adventurous	авантюрний
solace	розрада
bosom	лоно
cop a squat	присядь
cranky	вередливий
Will she get over it?	Чи вона впорається з цим?
willies	переляк
I am content	Я задоволений
badger me	мучити мене
pity	жалкий
I can look into it.	Я можу це розглянути.
step stool	сходинка
torch	факел
bumblebee	джміль
we got off on the wrong foot	ми встали не з тієї ноги
obligated	зобов'язаний
facilitate	сприяти
naughty	гріховний
flimsy	надуманий
pick on	дражнити
I get to wander around	Я можу тинятися навколо
bucket	відро
recess	перерва
dock foreman	бригадир доку
boobs	цицьки
chirp	цвірінькати
devolve	переходити
dung	гній
top off	дозаправляти
conflate	з'єднувати
woefully	жахливо
riled up	розлючений
rebuttal	спростування
merit	достоїнство
concede	припускати
validity	вагомість
savage	дикий
ejected	викинутий
sprinkle	посипати
reverence	благоговіння
puck	шайба
affection	прихильність
threw up in glove compartment	вирвав у бардачок
enroll full time	зарахувати на повний робочий день
incentive	стимул
rod	вудка
solid	твердий
ring up	дзвонити
catfish	сом
You bet.	Будь впевнений.
kickback	віддача
succumb	піддаватися
greed	жадібність
hereditary	спадковий
apply	застосувати
appliance	електричний побутовий прилад
stitches	стібки
gobbledygook	абракадабра
relent	послабитися
ripe old age	зрілої старості
layaway	розстрочка
disembodied	безтілесний
rivaling	суперництво
doozy	дурний
assume	припускати
suppose	припускати
darn tooting	ти до дідька правий
kickoff	старт матчу
Let's hit the road.	Вирушаймо в дорогу.
grapes	виноград
fascinating	захоплюючий
I see.	Розумію.
profoundly	глибоко
scrunched up	зморщився
pinched face	затиснуте обличчя
check in	перевірити
throw up	блювати
delinquent	правопорушник
bullying	знущання
eye-pecking	виколювання очей
peck	peck
take it up with	обговорити це з
he won't return my calls	він не відповідає на мої дзвінки
so far so good	все йде нормально
He is worked up about	Він схвильований
body of water	водойма
hang me up to dry	залишити мене напризволяще
finch	в'юрок
suitor	поклонник
browse	переглядати
tantrum	істерика
bug	мікроб
strained	напружений
give away	віддавати
phlegm	мокрота
tissue	серветка
fib	брехня
gotten away with it	зійшло з рук
quirky	дивакуватий
under the weather	хворий 
crotch	промежина
deceit	обман
naughty	неслухняний
made up for it	компенсувати це
suit up	одягатися
slack	провисання
He knock her up?	Він її обрюхатив?
peeved	роздратований
pick up the slack	підібрати ініціативу
startle	переляк
centerpiece	орнаментована ваза посеред стола
plain	простий
peck	клювати
skimp	бути скупим
stale	несвіжий
officiate	правити службу
aisle	прохід між рядами в церкві
I have bone to pick with you, Sir	У мене є до вас претензії, сер
admire	захоплюватися
urges	сильні бажання
have gotten off a rough start	почали важко
practice drills	практичні вправи
top notch	найвищий рівень
Beam your ass out of here.	Геть свою дупу звідси.
neat	чіткий
solemn vows	урочисті обітниці
dingus	дурачок
aggravation	обтяжлива обставина
rub	натирання
leap into	стрибнути в
derogatory	принизливий
jet ski	водний мотоцикл
drown out	заглушити
broiled	смажені
cranky	вередливий
busted	розбитий
accessory	допоміжний
ward	відділення лікарні
mole	кріт
in labor	в пологах
petroleum jelly	вазелін
racial slur	расова образа
incentivize	стимулювати
boast	хвалитися
humiliate	принижувати
swing	мах
mug	мармиза
hoist	піднімати
mean	злий
bow out	розпрощатися
appetizer	закуска
goofy	дурний
let me tag along	дозвольте мені піти разом
placard	placard
merit badges	нагрудні знаки
jocular insult	жартівлива образа
token	знак
I can dish it right back	Я можу це відразу повернути
bed-wetter	той, хто пісяється в ліжко
cinnamon	кориця
players will tie	гравці вирівняють
spice rack	підставка для спецій
dill	кріп
bragging	хвастощі
swat them away	відмахуватися від них
pull a leg	дражнити
graciously	люб'язно
wedge	клин
disparage	зневага
piddle	мочитися
alterate	чергувати
hearing aid	слуховий апарат
outing	виїзд
expelled in the exhaust	викидається у вихлоп
apt	доречний
slump	спад
mourn	оплакувати
garbage can	смітник
knees bent	коліна зігнуті
colander	друшляк
sift	просівати
flux	потік
lead	свинець
kiln	піч
plum	слива
pottery kiln	гончарна піч
collection plate	тарілка для збору пожертв
fibber	брехун
sacrilegious	святотатство
chump	бовдур
good luck charm	талісман удачі
nudge	підштовхнути
induce	спричиняти
delve	заглиблюватися у вивчення
assess	оцінити
emphasize	підкреслити
weighted	зважений
fathom	здогадуватися
cavern	карстова пустота
gone for good	пішов назавжди
eliminate	ліквідувати
aptly	влучно
imprint	відбиток
clunk	стукіт
peer into	вдивлятися в
perpetrator	злочинець
calamitous	катастрофічний
pesky	набридливий
stark	суворий
dwindle	зменшуватися
jug	глечик
I'm messing with you	я з тобою балуюся
aversion	відраза
funnel	лійка
I'm around tomorrow	Я завтра буду поруч
sneaky	підступний
bubble bath	пінна ванна
dormitory	гуртожиток
soiled	забруднений
hailstorm	град
charmer	чарівник
ribald	лихослов
help yourself	пригощайся
keg	бочка
win over	схилити на свою сторону
follow up question	подальше запитання
I'm due	я повинен
summon	вимагати виконання
booger	козявка
let's nail this down	давайте закріпимо це
layover	зупинка
turd	гівно
come over	приєднуватися
doldrum	депресія
jaunty	веселий
sweater-vest	светр-жилет
Aye	так
distract	відволікати
he puts on a heck of a show	він влаштовує неймовірне шоу
screwup	зіпсувати
ditch	рів
sleep through	проспати
attendants	обслуговуючий персонал
prevail	переважати
notion	поняття
unbuckled	розстебнутий
nauseous	нудотний
retch	блювати
cookout	кулінарія
gem	дорогоцінний камінь
excess	надлишок
bonehead	дурень
calf	литка
grumpy	сварливий
downtrodden	пригнічений
dismissed	звільнений
outrage	образа
footnotes	виноски
hazy	туманний
rob someone blind	пограбувати когось до нитки
apparel	одяг
bonnet	дитячий чепчик
mold	форма
spit the difference	сторгуватися
allegation	звинувачення
forensic examination	судово-медична експертиза
supervisor	керівник
fondness	нерозважлива прихильність
jeopardize	ставити під загрозу
arrogantly	зарозуміло
entitle	давати право
detrimental	згубний
tattle	пліткувати
bruised ribs	забиті ребра
collarbone	ключиця
clobber	побити
put out	виставити
incorporate	об'єднувати
rascal	розбійник
nutty	божевільний
get along	ладити
jackass	осел
stamina	витривалість
committed relationship	віддані стосунки
sulk	дутися
suffocate	душити
drop dead	впав замертво
chime in	вступати
I had a falling out	Я посварився
I will circle back to her	Я повернуся до неї
garlic	часник
got through to him	достукався до нього
disclose	розкривати
jeopardize	поставити під загрозу
was marred	був зіпсований
vile-smelling	мерзенний
shifty	ненадійний
fork over	розщедритися
lucky break	щасливий випадок
cranky	вередливий
shred	частинка
goony	дурний
get your way	добитися свого
wiles	хитрощі
understudy	дублер
deem	вважати
flatter	лестити
crank away	прокрутити
hot tub	джакузі
zinger	хитромудра відповідь
sensation	відчуття
payroll	нарахування заробітної плати
he'll come around	він прийде
extract	вирвати
stubborn	впертий
envision	передбачити
whisk you off	швидко вивести тебе
pickle	неприємне становище
sludge	осад
dandy	чудовий
that makes two of us	це стосується нас обох
thrill	трепет
bubble wrap	бульбашкова плівка
intestine	кишечник
assert	відстоювати
yearn	тужити
lowly	скромний
accessory	співвинуватець
grad school	аспірантура
spat	незлагода
plead a case	відстоювати справу
I'll chip in	Я долучусь
shed	сарай
root for	уболівати за
whopping	колосальний
rival	змагатися
reimbursement	відшкодування
Way to go!	Так тримати!
cranky	вередливий
seeing eye dog	собака-поводир
mild	помірний
pink eye	кон'юнктивіт
tape	записувати відео
pitcher	глечик
rascal	негідник
cleats	бутси
your sound on the fence	звучиш нерішуче
impending	що насувається
dust the picture	прибрати пил з картини
it got me out of driving	це позбавило мене водіння
report for duty	з'явитися на чергування
contribute	сприяти
soot	сажа
Have at it!	Приступай!
anticlimactic	розчаровуюче
chug	пихтіти
drop chute	спускний жолоб
drop chute toilet	унітаз
aisle	прохід
yarn	пряжа
cast on	накидати
spell	заклинання
jock	спортсмен
icicle	бурулька
bouncer	вишибала
slingshot	рогатка
nogging	роздуми
jig	витівка
leash	повідець
swoll	набряк
fracture	перелом
in a cast	в гіпсі
deface	зіпсувати
join ranks	вступати в ряди
beef jerky	в'ялена яловичина
adversity	нещастя
crankiness	вередливість
dampen	послабляти
bitchin	офігенний
ulna	ліктьова кістка
I was fixing to	Я збирався
trivia	дрібниці
emphasis	наголос
trash talk	пуста балаканина
chariot	колісниця
polyhedral	багатогранний
slab	кусок
poke around	колупатися
mother-in-law	свекруха
put up with	миритися
musty crypt	затхлий склеп
booby-trapped	замінований
inadvertently	ненавмисно
apricot	абрикос
dismissive snort	зневажливе пирхання
peel	шкірка
you turned me down flat	ти мені навідріз відмовив
calloused	мозолястий
spectacular	видовищний
plum	слива
graft	щепити
anticipate	передбачити
plaid	клітчастий
obnoxious	противний
condescending	поблажливий
mortify	принижувати
curveballs	кручений м'яч
break the mold	розірвати шаблон
call for	закликати до
waylaid	підкараулити
setback	невдача
forge	підробляти
forge ahead	просуватися вперед
walrus	морж
admission	вступ
bound	прив'язаний
abundantly	рясно
sassy	нахабний
contempt	презирство
call it a day	завершити день
acquisition	здобуття
smirch	ганьба
incessant yammering	безперервне лепетання
pressing	нагальний
genealogy	родовід
plot	затія
contemplate the furtility	споглядати марність
haul	тягнути
flunk	ухилятися
epistemology	теорія пізнання
bawl	згукувати
snap out of it	вирватися з цього
beguiling	спокусливий
oatmeal	вівсяні пластівці
cynicism	цинізм
yelp	викрик
olden	колишній
bummer	облом
acumen	кмітливість
repercussions	наслідки
prattle	балаканина
trot out	хизуватися
upkeep	вартість утримання
scholarship	стипендія
get by with	обійтися з
head count	підрахунок кількості людей
organ grinder's monkey	мавпа шарманщика
rallies	мітинги
rookie	новачок
footloose	розпущений
overalls	комбінезон
leap	стрибок
belly button	пупок
devise	придумати
folly	дурість
thingy	штучка
magnitude	величина
repulsive force	сила відштовхування
bobblehead	пупс
toil	труд
rabies	сказ
plaintiff	позивач
bailiff	судовий виконавець
stingy	скупий
persuasion	переконання
bribery	хабарництво
besmirch	заплямувати
flattery	лестощі
hunched	згорблений
hounding	переслідування
persuade	переконувати
relentless	невблаганний
grease	мастило
pizazz	шик
tedious	нудний
menial	слуга
crate	ящик
strip a wire	зачистити дріт
sweep up	підмести
commitment	зобов'язання
grouchy	буркотливий
vigor	бадьорість
reaction rate	швидкість реакції
hay bales	тюки сіна
boilerplate legalese	шаблонний закон
stammer	заїкатися
dingy	брудний
hatch	висиджувати
undeterred	не зляканий
saddle up	осідлати
Rustle up some muscles	Розімніть м'язи
loafers	мокасини
Carry on	Продовжуй
glitz	блиск
Happy trails	Щасливої дороги
rebuttal	спростування
I missed this	Я скучав по цьому
jumbo	гігантський
suspend	вішати
I drove past	Я проїхав повз
heart pounding	серце калатає
junkie	наркоман
scintillate	мерехтіти
adhesive	клей
hit the john	сходити в туалет
barbed wire	колючий дріт
chopstick	паличка для їжі
bravado	хвастощі
keychain	брелок
dagger	кинджал
geezer	дивак
commencement	початок
shuttle service	трансфер
get around	пересуватися
shrivelled up	зморщився
grim	похмурий
gobble up	зжерти
hard candy	льодяник
catch fire	загорітися
destitute	бідний
don't test me	не випробовуйте мене
preposterous	абсурдний
coast	рухатися по інерції
Beat it!	Відвали!
feisty	злющий
cordial	сердечний
irritable	дратівливий
don't push it	на наполягай на цьому
why rob her of that	навіщо її позбавляти цього
well-rounded individual	всебічно розвинена особистість
coax	вмовляти
work around the clock	працювати цілодобово
crave	жадати
rare	недосмажений
lettuce	листя салату
tampering	підробка
leap	стрибок
fair skin	світла шкіра
leechers	п'явки
pool cue	більярдний кий
beat us to the punch	випередити нас
checkup	перевірка
broad	дівчинка
impeccable	бездоганний
ass	осел
showdown	розборки
deductions	відрахування
itemized	деталізований
justify	виправдати
well-versed	добре обізнаний
smug	самовдоволений
pep	бадьорість
contend	боротися
insidious	підступний
upend	перевернути
I nailed it	Я впорався
контрабанда	контрабанда
wrapped 	охоплений
deck	колода
tramp	пройдисвіт
bickering	суперечки через дрібниці
you put me on the spot	ти поставив мене на місце
boon	благо
bask	тішитися теплом
enroll	записуватися
thigh	стегно
perm	хімічна завивка
foxy	привабливо
make a fuss over	здіймати галас
substandard	неякісні
settle	селитися
pouty	надутий
unrequited	нерозділене
aggravation	погіршення
flutter	тріпотіти
requited	відплачений
pucker up	зморщитися
tickle	лоскотати
spiffy	вишуканий
chime	дзвонити
hoot	кльовий
carve	вирізьблювати
lurch	хитка позиція
petty	незначний
mop	швабра
orthodox	загальноприйнятий
hallow	освячувати
pick on	прискіпуватися
what are you getting at	до чого ти ведеш?
maelstrom	вир
pacifier	соска-пустишка
hump	горб
memo	записка
stumper	тупік
binding	обов'язковий
tetanus	правець
rink	каток
angina pectoris	стенокардія
accomplice	співучасник
get winded	задихатися
devolve	переходити
maintain	стверджувати
hide	шкіра
quandary	скрутне становище
Hangin in.	Зависати.
incentive	стимул
enforce	примушувати
horrendous	страхітливий
burrow	нора
foreshadow	передвіщати
run it over	принести
a little out of it	трохи не в собі
dazzling 	приголомшливий
wry musings	криві міркування
jet lag	відставання від часових поясів
slither	ковзати
rec room	кімната відпочинку
off guard	зненацька
polecat	тхір
squirm	звиватися
curb	обочина
redeem	викупити
commandment	заповідь
snoop	підглядати
tick	образитися
blab	базікання
smoker	коптильник
coiled	завернутий у спіраль
unleash	спускати
soar	підноситися
elusive	невловимий
patronize	опікуватися
faculty mixer	корпоратив
talk some sense into	напоумити
apron	фартук
content	задоволений
crunchy	хрусткий
scramble	через силу зробити
pan out	складеться
pamphlet	брошура
ditch	пускати під укіс
drop out	пропускати
nurture	виховувати
destined	судилося
seniors	старшокласники
rile	роздратування
hooch	самогонка
affinity	спорідненість
sudsy	пінний
tab	рахунок
cash out	виведення готівки
close up for good	закрити назавжди
utensil	посуд
legal pad	юридичний блокнот
skedaddle	тікати
faux	штучний
thorough	ретельний
down the line	кінець кінцем
speakeasy	підпільний заклад
rhinestones	стрази
tumble dry	сушити в сушильній машині
science posse	науковий загін
tidbits	ласі шматочки
superstition	забобон
concubine	наложниця
get over it	закінчуй з цим
spiffy	вишуканий
chime in	підключитися
aphid	тля
procreation	продовження роду
intercourse	статевий акт
stammer	заїкатися
abstinence	утримання
doozy	дурнуватий
naughty	неслухняний
tizzy	тривога
incur goodwill	викликати доброзичливість
fornicate	робити перелюб
bland	ввічливий
hereby	цим
coined	придуманий
ask out	запросити на побачення
rebound	відбитий
you fancy yourself	ти себе уявляєш
call the shots	керуйте
con man	аферист
give it a shot	спробуйте
crackpot	божевільний
eat crow	опозоритися від того, що був такий впевнений, а виявилося, що неправий
sack	мішок
go south	провалитися
mug	кружка
scoring goals	забивати голи
distinguish	розрізняти
antagonism	протидія
derivative	похідна
merit	заслуги
take a bath	постраждати від фінансових втрат
storied history	легендарна історія
midterms	проміжні екзамени
glob	крапля
trudge	тягнутися
keel over	перекидатися
sincere	щирий
willy nilly	волею-неволею
intimidate	залякати
recliner	крісло
bleak	похмурий
enthralling	захоплюючий
asset	актив
tenure	перебування на посаді
fall off	відвалюватись
dismissed	звільнений
scrub	терти
exasperation	роздратування
crabby	дратівливий
hose 	шланг
coddle	пестити
get bent out of shape	втратити форму
pout	дутися
take charge	взяти відповідальність
excitation	хвилювання
chip on a shoulder	вкорінене почуття образи
smug	самовдоволений
majors	спеціальності
pick up on	підхопити
cog	гвинтик
untapped	невикористаний
dig 	глузування
go down swinging	боротися до останнього
shebang	фігня
parlor	салон
booze	випивка
luminarie	світило
on the off chance	на випадок
deploy	розгорнути
gravitas	важливість
rip the lid off	викрити
scoop	сенсаційна новина
alley	провулок
butt out	не лізь
budge	зрушити з місця
I've been had.	Мене обдурили.
integrity	цілісність
barge into	вриватися
detrimental	згубний
barf	блювотина
homewrecker	розлучник
yips	мандраж
cobbler	фруктовий пиріг
thud	глухий звук
onset	початок
big whoop	нема ради
faucet	кран
pop over	вискочити
hitch up	підтягувати
I am blanking	Я відключаюся
tingle	дрижати
extolled by the sages	оспівуваний мудрецями
I zoned out	Я відключився
sage	мудрий
jiggle	похитувати
buffing	полірування
school board	шкільна рада
vicariously	опосередковано
sap	зубрило
lumbar	поперековий
downtime	час простою
parlay	збільшувати вартість
accommodating	люб'язний
yuck	гидота
arrogant	пихатий
deference	повага
entitled brat	заслужений нахаба
shallow	поверхневий
till	каса
subordinate	підлеглий
rash	висип
scabies	короста
ace	добитися успіху
squabble	сварка
goof-off	байдикувати
chaperone	супроводжувати
fraternize	брататися
rayon	штучний шовк
soak	замочувати
dibs	я хочу і вимагаю щоби я перший
sardines	хованки
hilarious	веселий
filing cabinet	картотека
stash	ховати
linebacker	півзахисник
cowpoke	ковбой
knack	вправність
buckle down	пристібатися
congregate	збиратися
collegiate	студентський
sputter	бризкання
slather	намазати
exfoliate	відлущувати
raffle	розіграш
pusillanimous	малодушний
fascinating	захоплюючий
take a gander	глянути
fisticuffs	кулачні бої
reveler	гуляка
wrath	гнів
emollient	пом'якшувальний засіб
oozy	вологий
blasting 	вибуховий
tights	колготки
pitchfork 	вила
put out	гасити
hook up	підключити
things are looking up	справи йдуть на краще
delight	втіха
surrender	здатися
collarbone	ключиця
coaster	підстаканник
chest	ящик
bout	бій
tussle	боротьба
hinder	перешкоджати
vote of confidence	вотум довіри
feeble 	слабкий
Them's the breaks	Ніц не зробиш
impugn	заперечувати
outmoded	застарілий
I swoop in	Я вриваюся
wiles	хитрощі
splurge	хвастати
for crying out loud	Здуріти можна
mere	просто
strangle	задушити
umbilical cord	пуповина
essentially	по суті
pimple	прищ
pizza face	прищавий
wage a war	вести війну
lighten the mood	піднімати настрій
curb	бордюр
prevail	перемогти
bum a ride	проїхатися
swap	міняти
snot	шмарклі
pressing matters	нагальні справи
reluctance	небажання
absent-minded	розсіяний
tranquility	спокійність
coffin	труна
shifter	перемикач
sendoff	відправа
keep on toes	триматися на ногах
tangent	дотична
take over	приймати
float the idea	висунути ідею
fumble	незграбне поводження
handout	милостиня
revel	бенкетувати
giddy	запаморочення
thriving	процвітаючий
rest assured	будьте певні
shack	халупа
butterscotch	іриска
trunk	багажник
savor	смакувати
bolster	підтримувати
slump	спад
nip	укус
nip at heels	натупає на п'яти
tycoon	магнат
pitcher	глечик
thriving	процвітаючий
infestation	зараження
rite	обряд
dazzle	засліплювати
chaperone	супроводжуючий
trot out	хизуватися
stiflingly	задушливо
freak out	біситися
Jack squat	взагалі нічого
snitch	донощик
pad	прокладка
frantic	шалений
prolific	плідний
nightfall	сутінки
at this rate	з такими темпами
go over your head	ти не зрозумів
bonk	лупити
doze off	задрімати
compelling	переконливий
reminiscent	що нагадує
palpable	відчутний на дотик
resplendent	чудовий
sausage party	вечірка без жінок
champ	чемпіон
wedlock	шлюб
cling	чіплятися
lead time	час виконання
roll in in a moment's notice	миттєво з’явитися
eager	охочий
bozo	тип
upbringing	виховання
matrimony	шлюб
incremental	поступово зростаючий
proprietary	патентований
creek	струмок
to get your take on	дізнатися твою думку
bambino	дитятко
expletive 	лайка
workaround	обхідний шлях
duck calls	ухилятися від дзвінків
make up for	компенсувати
yank	смикнути
jim dandy	в повному порядку
safe to assume	можна припустити
bump into	натрапити на
business at hand	поточна справа
holy roller	християнський позер
we are held to	ми дотримуємося
oatmeal	вівсяні пластівці
poppy seed bagel	бублик з маком
sunblock	сонцезахисний крем
I'll trade you.	Я би з тобою помінявся.
got a handle on	впоратися з
pus	гній
signpost	покажчик
zit	прищ
dash hopes	розбити надії
litigation	судовий процес
mark up	підвищити ціну
strife	чвари
strapping	дужий
buckle	згин
classifieds	оголошення
sulk	дутися
hell bent	одержима
commodity	товар
payroll	нарахування заробітної плати
groovy	захоплююче
customs	митниця
smuggling	контрабанда
plead	виправдуватися
post a bond	внести заставу
loiter	тинятися без діла
he is going out of his way	він робить усе можливе
table	відкласти на потім
running on fumes	дуже втомлений
vivacious	жвавий
giddy	запаморочення
nuptials	весілля
bastard	позашлюбна дитина
imply	мати на увазі
swerve	відхилення
butter up	улещувати
abundant	рясний
помиї	юшка
barley	ячмінь
taste buds	смакові рецептори
swoon	непритомніти
waltz	вальс
mitts	рукавиці
whim	примха
vicinity of	околиці
frontier	рубіж
it rattled you	це тебе збентежило
envy	заздрість
counterfeiting	підробка
sow	сіяти
toss 	скидати
hot diggity dog	ну нічого собі